*************
*........F***
*..****..****
...*** ..****
.****....**..
..***....*..*
*************

