***************************
..........*.....*.......F..
******.**.*.....*.**.******
******.**.***..**.**.******
******.**.........**.******
******.*****.**.****.******
******.*****.**.****.******
*......**....**...**......*
*.****.**.**. ..*.**.****.*
*.****.**.*.....*.**.****.*
*.........F...............*
*.****.*****.**.****.****.*
*.****.*****.**.****.****.*
*.****.*****.**.****.****.*
*............**.......F...*
*........**..............**
***************************