*************
*........F***
*...***..****
....***..****
.****....**..
..***. ..*..*
*.......**..*
**...**....**
*...***...***
***.....*.***
**..F**.....*